20 20
h  h  h  h  h  h  h  h  h  h  h  h  h  h  h  h  h  h  h  h  
h  c  b  h  e  e  e  e  e  e  e  e  e  e  e  e  e  b  c  h  
h  av h  h  e  h  h  h  h  h  h  h  h  h  h  h  h  h  e  h  
h  e  h  e  e  e  e  e  e  sh e  e  e  e  e  p2 h  h  e  h  
h  av h  e  h  h  h  h  h  h  h  h  h  h  h  h  p2 h  e  h  
h  e  h  e  h  e  e  e  e  e  e  e  e  e  e  h  e  h  e  h  
h  av h  e  h  e  h  h  h  h  h  h  h  h  e  h  e  h  e  h  
h  e  h  e  h  e  h  e  e  e  e  e  e  h  e  h  e  h  e  h  
h  av h  e  h  e  h  e  h  h  h  h  e  h  e  h  e  h  e  h  
h  h  h  e  h  e  h  e  h  c  b  h  e  h  e  h  e  h  e  h  
h  e  h  e  h  e  h  e  e  e  w  h  e  h  e  h  e  h  e  h  
h  e  h  e  h  e  h  h  h  h  h  h  e  h  e  h  e  h  e  h  
h  e  h  e  h  e  e  e  ah e  e  e  e  h  e  h  e  h  e  h  
h  e  h  b  h  h  h  h  h  h  h  h  h  h  e  h  e  h  e  h  
h  e  h  c  e  e  e  e  e  e  e  e  e  e  e  h  e  h  e  h  
h  e  h  h  h  h  h  h  h  h  h  h  h  h  h  e  e  h  e  h  
h  e  e  e  e  e  e  e  e  e  e  sh e  e  e  e  e  h  e  h  
h  h  h  h  h  h  h  h  e  h  h  h  h  h  h  h  h  h  b  h  
h  e  e  e  e  e  e  e  e  e  e  e  e  e  e  e  e  e  c  h  
h  h  h  h  h  h  h  h  h  h  h  h  h  h  h  h  h  h  h  h  
