20 20
e  e  e  e  e  e  e  e  e  e  e  e  e  e  e  e  e  e  e  e
e  e  e  e  e  e  e  e  e  e  e  e  e  e  e  e  e  e  e  e
e  e  e  e  e  e  e  e  e  e  e  e  e  e  e  e  e  e  e  e
e  e  e  e  e  e  e  e  e  e  e  e  e  e  e  e  e  e  e  e
e  e  e  e  e  e  e  e  e  e  e  e  e  e  e  e  e  e  e  e
e  e  e  e  e  e  e  e  e  e  e  e  e  e  e  e  e  e  e  e
e  e  e  e  e  e  e  e  e  e  e  e  e  e  e  e  e  e  e  e
e  e  e  e  e  e  e  e  e  e  e  e  e  e  e  e  e  e  e  e
e  e  e  e  e  e  e  e  e  e  e  e  e  e  e  e  e  e  e  e
e  e  e  e  e  e  e  e  e  e  e  e  e  e  e  e  e  e  e  e
e  e  e  e  e  e  e  e  e  e  e  e  e  e  e  e  e  e  e  e
e  e  e  e  e  e  e  e  e  e  e  e  e  e  e  e  e  e  e  e
e  e  e  e  e  e  e  e  e  e  e  e  e  e  e  e  e  e  e  e
e  e  e  e  e  e  e  e  e  e  e  e  e  e  e  e  e  e  e  e
e  e  e  e  e  e  e  e  e  e  e  e  e  e  e  e  e  e  e  e
e  e  e  e  e  e  e  e  e  e  e  e  e  e  e  e  e  e  e  e
e  e  e  e  e  e  e  e  e  e  e  e  e  e  e  e  e  e  e  e
e  e  e  e  h  e  e  e  e  e  e  e  e  e  e  e  e  e  e  e
e  e  e  e  e  e  e  e  e  w  e  e  e  e  e  e  e  e  e  e
e  e  e  e  e  e  e  e  e  e  e  e  e  e  e  e  e  e  e  e